A0 0 0 B0
A1 0 1 A2 B1
A2 0 2 A1 B2
A3 0 3 A4 B3
A4 0 4 A3 A5
A5 0 5 A4
B0 1 0 A0 C0
B1 1 1 A1 C1
B2 1 2 A2 B3
B3 1 3 A3 B2 B4
B4 1 4 B3 B5
B5 1 5 B4 C5
C0 2 0 B0 C1 D0
C1 2 1 B1 C0 D1
C2 2 2 D2
C3 2 3 C4 D3
C4 2 4 C3 C5
C5 2 5 B5 C4
D0 3 0 C0 E0
D1 3 1 C1 E1
D2 3 2 C2 D3
D3 3 3 C3 D2 D4
D4 3 4 D3 E4
D5 3 5 E5
E0 4 0 D0 F0
E1 4 1 D1 F1
E2 4 2 E3 F2
E3 4 3 E2 E4 F3
E4 4 4 D4 E3 E5 F4
E5 4 5 D5 E4
F0 5 0 E0
F1 5 1 E1 F2
F2 5 2 E2 F1
F3 5 3 E3
F4 5 4 E4 F5
F5 5 5 F4
Luigi F5
Exit F3